*$*$$$$$$*$***$$**$$$$$$$$$$***$$$$$$$*
$$$$*$*$$*$$$*$$$*$$$$**$$*$$*$$$$$$$$*
$$$$$$$*$$$$*$***$$*$*$*$$*$**$*$$$$**$
$$*$$**$***$$$$$$$*$$$*$*$$$$*$$$$*$$**
$$$$$$*$$$$$*$$$$**$$$**$*$$$*$$$$$$$*$
$$$$$$$$$$$$*$$$$*$$*$**$$$$$$*$$$***$$
$$$$**$*$$$*$*$$$$$$*$$$$$$$**$$$$$$$$*
$$$$**$$*$****$$*$$$$$*$$**$*$***$$$$$$
$$$$$$$$$$$$$$*$$$$$**$$$*$***$$$*$*$**
$$$$$$$$$$$**$$$*$$$*$$$**$$*$$$$$$$$**
$*$*$**$$$$$$$$$$$**$*$$*$*$$*$$$*$$$*$
$$$$$$$$$$$$**$*$$$$$*$$*$*$$$$$$$**$$$
$*$*$$$$$$$$*$**$$*$$**$$**$*$$$*$$$*$$
$$$$$$*$**$*$$$*$$$$$$$$*$*$$$$$$$$$$$$
$$$$$$$$$$$$$**$$*$$$$$$$$$**$$$$*$$*$$
$$*$*$$$*$*$$$*$*$*$$$$$*$$$**$$$$$*$$$
$**$$*$$*$$$*$*$$$$*$$**$$**$$$$$*$$$**
$$$$$**$$$$$**$$$***$$$**$$$*$**$$$$$$$
$$$$$*$$$*$*$$*$*$*$*$$$*$**$$$$*$*$**$
*$*$$$$$*$$$$*$$***$*$**$$$$$*$$$$*$*$$
$$$$**$$$$$$$$$$**$***$$$**$$$**$$$$$$*
$***$$***$**$$$*$*$$$$*$$*$$**$**$$$$$$
$$$$$$$*$$$$$**$*$$$$$$$$*$$$$*$$$$$$*$
$$*$$$$***$$$$***$*$*$$$*$$$$$*$$$$$$$$
$$$$$*$$$$$$*$$*$*$$$$$*$$$$***$$$*$$$$
$**$$$$$$*$*$$$$$$$$$$$$$$$$**$$*$$$$$$
*$*$$$$$*$*$$**$*$$$$$***$$$*$$$**$*$**
*$**$$$$$$$***$$$$$$$$$$$*$$$$$$$$$$**$
**$$$$$$*$$$$$*$$$*$$$$*$$$*$$*$$$$***$
$$$$*$$$$$$$$$*$**$$$*$$$$$$$$$$$$**$$$
$**$*$*$$$*$$$$$$*$$$$$$$$$$$*$*$$$$$$*
$$$****$$*$$$$$$$$*$$$$$$*$*$$$$$$*$$$*
*$$$*$***$$$$*$$$$*$$$$$$*$$$$*$$$$$*$$
*$$$$$$$$$$$*$$$$$*$$$$**$$$$$*$$$$$$$$
$*$*$*$$$$$$$$$$*$$*$$*$$$$**$$$$$$$*$$
*$$***$**$$$$$*$$$*$$$$$$$$*$$$$$$$$$*$
$$$$$$**$$**$$$*$$*$*$*$*$$$$$*$*$$$$$$
****$$$$$**$$$$**$*$*$$$*$$*$**$$$$*$*$
$$$$$$$$**$**$$*$$$$$**$$*$*$$*$*$$$$*$
$$**$$$$*$*$$$$$$$*$$$$$$$*$$$$*$$**$$$
$$$*$$$*$*$**$$$$$$*$$$*$$*$$$*$$$$$$$$
$$$$$$$$*$$$$$$$*$$*$$$$*$*$**$$***$$**
$$$$**$*$*$*$$$$$*$$$$**$*$*$*$$$$*$*$$
$$$$$$$$$$**$$$$$$$$$$$$$$$$$*$$*$$*$$*
***$*$$$*$$$$$$*$$*$******$$$$$$$*$***$
$$$$$$$*$*$*$$$$$$$$$$*$$*$*$*$*$$$**$$
$$$$$$$$$$$$$$$*$$$$*$*$$$*$*$$$$$$**$$
$**$$$$*$$$$$$$$$$$$**$$$$$$*$$$$$$$$*$
$$*$*$*$$$$*$$$$$$$$$$$$$$$*$$$$$$$$$$*
*$$$$$$$$*$$$$$$$$$$****$$*$*$@*$$$$$$$
*$$$*$*$*$$$$*$$$$$*$$*$*$*$$$*$**$$**$
$$$*$$*$$$$$$$*$*$$$**$*$$*$$$$*$$$$$$$
$$*$$$*$$$$$$$$$*$$$*$$$$$$$$$$***$*$$$
$$*$$$$$$*$$*$$$$$$$$*$$$***$*$$$$$*$*$
$$$$$$$$*$*$$$$$**$$$$$$$$$**$$$*$$$$$$
$$*$$**$$**$*$$$*$$***$$$$*$$$$$$$$*$*$
$**$*$*$$$*$$$$$$$**$$$$$$*$$*$**$$$$$$
$**$$$$$$*$*$$*$$$$$$$$$$*$**$*$$$**$$$
$**$**$$$$**$$*$$$$$$**$$$*$$$$$**$*$$*
$$$$*$$$*$***$$*$$*$$*$$$$*$*$$$$*$$$**
$*$$*$$*$**$$**$$$$$$$*$$$*$$*$$**$$$$$
$*$$$$$$$$$$*$**$$*$$$$$$*$$$*$$$**$$$*
$**$$$$$$*$$*$$$$*$$$$*$$$*$$$$*$*$**$*
*$$$$$$**$$$*$*$*$$$*$*$$$*$*$$$*$$*$$$
****$$*$$$$$$$*$$$$***$*$$$$$$$**$*$$$$
$*$$$$*$**$$$****$$*$$*$$$$$$****$$$$$$
***$$**$$$$$**$***$$$$$$*$$$$$$$*$$$$$$
*$$$$$$$$$$$***$$*$$*$$$**$*$$$**$$$$$$
$***$$$$$$$$$*$$$$$$$*$$$$$$*$$$$$$**$$
$$*$*$*$*$$$$$$$$**$$$*$$$*$$$$$$$$$*$$
$$$$$$$$$$****$$*$$$$$$**$**$$$$$$$*$**
$$**$$*$$*$$$**$*$$*$**$$*$$$$*$$$$*$$$
$$*$*$****$$$*$$$$$$*$$$$$$*$*$$$$$**$*
*$$$$*$$$$$$$$$$$*$$$$*$$*$$*$$$$***$$*
$$*$$$*$$$$$$$$$$$$$$$$$$$$$$$*$$$$$$$*
$$$***$$$$$$$$$$*$*$$*$$$$**$$$*$$$$$$$
$$$$$**$$*$*$$*$*$$$*$$$$$$*$$$$***$$$$
$$$$$$$$$*$$$$*$$$$$*$$$$$***$$$*$$$*$$
