$$$***$$*$*$*$$$$$**$$*$$$$*$$$$$*$$$$$$$$$*$$$*$$$*$$*$$$$$&$**$*$*$***$$*$$*$**$$$$$$$$$$$$$$
$$*$$**$$$$$$*$*$$*$$$$$**$$*$$$$**$$*$*$$$$*$$*$$$$**$$*$*$$$*$*$$*$$$$**$$$$*$$$$$$$$$$***$*$
$$**$*$$$*$$$**$$$*$$$$$$$$$$$***$$$$$$$$$$$*$$*$$$$$*$$***$**$$$$*$$$$$$$$**$$**$$$$*$*$***$**
$$$$*$$$*$**$$*$*$$$$$**$$*$$*$$$*$$$*$*$$$$$$$$$$$$$***$$$*$*$$$$$$$**$*$$$$**$$$$$$*$$$$$$$$*
$$$$$$**$$**$*$$$$*$*$*$*$$$*$$$$*$$$$$$$*$$$$$****$$*$**$*$$$$$$$*****$$**$$*$*$$*$$$$$*$$*$**
***$$$$$*$$$$$$$$$$$***$$**$$****$$*$$$$$$$$*$$$$**$*$$*$*$*$*$*$*$$$$$$*$$$$$*$*$$**$$$$$**$$$
$**$$*$*$$**$$$*$**$$*$$***$$$*$*$$*$$$$$$$*$$$$$*$$*$*$*$$$***$$$$$$$$$$$$$*$*$$*$*$$*$*$$$$$$
$$$$*$$$$$$$*$$$$$$*$**$$$$$$$$*$$$$*$$*$$$*$$$$$$$$$$$$***$$*$$$$$**$$$*$$**$$$$$$*$$*$$$*$*$$
*$$$*$*$$$$*$*$$$$$*$$*$$$$$$$$$$$*$$$$*$$$$$$$$$$$*$*$**$$*$$$$$$$$$$*$*$*$$$$$$*$$$$$$$$$$$*$
***$$$$$$$$**$*$$$**$$***$$*$$$$$$$$$$$**$$$$$*$*$*$$$*$$$$$$**$$*$$**$$$*$$$$$*$$**$*$$$$$$$$*
$$***$***$*$$*$$$$$**$$$$$$$*$*$$*$$$$$*$$$$$$$$$*$$$*$*$$$$$**$$$$$$$*$*$**$*$$$$$$*$$**$$$*$$
$*$$$$***$$*$$$****$*$$$$$$*$*$$***$$*$$*$$*$*$*$$$$$$***$$$*$$$**$$$*$*$$$$$**$$$$**$$$$$$$$$$
*$$$***$$**$$$$$$$$*$$$$$$*$***$$**$*$$$*$*$*$$*$$$$$*$*$$$***$$$$*$$**$$$**$$$$$$$$$*$$$$$**$$
*$*$$*$$$*$$$*$$$$$$**$$$$$*$$*$$$$$*$*$$$$$$$$$$*$$***$*$$$*$$$$$*$*$$$$*$$$*$$*$*$*$$$$**$$$$
$$$$***$*$$$*$$$$$$$$*$*$*$$$$$*$$*$*$$$****$$$*$*$$$$$$$$$$$$$$$$**$$$$$$$**$$$***$$$*$$*$$$$$
$$$$$$$$$*$*$$$$$$$$$*$$$$$$*$**$$$$$$$***$$$$$$$**$*$*$$**$$$$$$**$$$*$*$$$**$$$**$$$$$$$$*$*$
$$$*$$**$$$$$$$$$$$$$*$$$$$**$$**$$$*$$$$*$**$$$$**$$$*$*$*$$*$$$$$$$$*$*$**$**$$$$$$$$$$*$$$$$
$$*$$$$$$$$$$**$$**$*$$$**$$*$$$$$$$$@$*$$$$*$*$*$*$$$*$$**$*$$$$$$$$$*$***$**$$*$$$$*$*$$$*$$$
$$$$$*$$$$$$$*$*$*$*$$$$$$$*$$*$$***$$$$$$$$*$$$$**$*$*$*$$*$**$*$**$$$$$*$$$**$*$$$*$$$$*$$$$$
$$$*$*$$*$$$*$$$$$*$$$$$$$$*$$$$$$$$$$**$***$$$$$*$**$*$$*$**$*$*$$$$$*$*$$$$$$$$*$$*$$$*$$*$$*
