*$***$$**$$$$****$$$
$**$$*$$***$*$$$$$$*
$$*$$$*$$$$*$$*$*$$$
$$$$$$*$$$*$*$$*$$$$
$$$$$$**$*$***$$$*$$
*$**$$$*$*$$$*$*$$$$
$*$$$*$$$$*$$*$$*$$*
*$$$$$*$$$**$$*$*$**
$$$$$@$$$$*$$$***$$$
$*$$$$*$$$$$$*$$$$$$
$$$$$$*$$$$$$*$$$$$*
*$$$$$$$$$$*$*$$$*$$
*$$$****$*$$$$$$$$$$
$$$*$$$*$$$$$$*$$$$*
**$$*$$*$$*$$$$$*$*$
$$$$*$$*$$*$$$$*$$*$
$$$$$$$$$$*$**$$$$**
***$$$$*$$$$*$$$*$$$
$$*$*$**$$$$*$$$$$$$
$*$*$$$$$$$$$$$$$*$$
$$*$$*$$$$*$$$$*$$*$
$$$$**$$$$*$$$$*$*$$
$$$$$$**$$$$$$$$$$$*
*$$*$$$$***$$$*$$$$*
*$$***$*$$$*$$$*$$**
