$$$**$$$$$$*$$$$$$$$$*$$$$$$$$$***$$*$$$$$$$$*$$*$$*$$$$$$*$*$$**$$**$$$*$$$$$$$$$*$$$$$$$$$
$$$$$*$$$*$$$$*$*$$*$$$$**$$$*$$*$$$*$$$$$*$$$$$$$*$$$$$*$*$$$$$$$$*$*$$$$$*$$$*$$$$$$$$$$$$
$*$$*$**$$$$$$$**$$*$$$$$$$$$*$$$*$$*$$$*$*$$$*$*$$$*$$*$$*$*$*******$$*$$*$*$*$$$$**$$*$$*$
$$$$$$$**$$$$$$**$$*$$*$$$$$$*$$*$$*$$$$$$$$*$$*$$*$$$$*$$$*$$$$$*$*$$$$*$$$$$$$$*$*$$$$$$*$
$$$$$$$$$$$*$$$$**$**$***$$$*$$*$$*$$$*$**$$$***$$$*$$*$$$**$*$$*$*$$$***$*$*$$*$*$$$$$$**$*
**$**$$*$$*$*$$*$***$$$$$$$$$*$*$$**$$$$$$$$$*$$$$$$*$*$$$$$$$$$$$*$$$*$$$$$$$$**$$*$$*$$$$*
$*$$$$*$$$**$$$*$*$$$$*$$$$$$$$$*$$*$$$$$$$$$$***$$$****$*$$$*$***$$$*$$$$$***$$$$*$$*$$***$
$$$*$*$$**$$$*$$$$*$$$*$$$$$$$$*$$$$*$$$$$*$*$$$$*$$*$$*$$$*$$$$***$$$$$*$$$$$$$$$$$$*$$$$$*
$*$$$$$**$$$$*$$*$*$$$$$$*$$$*$$**$$$$$*$$$$$$***$$$*$*$$$$$$$$$*$$$$*$$$*$$*$$$$$$*$*$$$*$*
*$$*$$*$$*$$$$$*$$$$$$*$$$$*$$**$$$*$**$$$$$$*$$$$$$*$$$$*$$$$$**$$****$$$**$*$$*$$$$$$*$*$$
$$$$*$$**$**$$$$$$$$$$*$$$*$*$$*****$$$$$$$*$$$$$**$$*$*$$$$$$*$$*$$$*$$$**$$$*$$$$*$$$$$$$$
$$$$$**$$$$$*$$$*$$$$$$$$$$**$$$*$$$$$$$$$$$$$$$$$$**$$*$**$*$$$$*$*$$**$*$*$$*$*$$$*$$***$$
$*$$$*$**$*$$$$*$$$$$*$*$$*$$$$*$$$$$*$*$$$$$$$$$$******$$$$$$$$$$$**$$$$*$*$$$$$$$$*$$$$*$$
$*$*$$**$$*$**$$$*$$$*$$$$$$$$$$$*$*$$*$$$*$$$$$$$$$*$$$*$$$$$*$$$$$$$*$$$$*$*$$*$$*$**$$$$$
*$$*$$$$$*$$*$$*$$$$$$$$$$$**$$$$$$$$*$*$$$$**$$**$$$$**$*$$$$$***$$*$**$$$$$*$$$$*$$$$$*$$$
$*****$$$$$$*$$$$$$$$$$$$$$**$$$*$$$$*$$**$*$$$$$$$$$$$*$$$$$*$$$**$$$$**$$$$$$$$$*$$$$$$*$$
$$$$$$**$$*$$***$*$$*$$$$*$*$$$$***$$$*$$$*$****$$$$*$$$$*$*$$$*$$*$*$$$*$$*$$$$$**$**$*$*$$
$$$$*$$$**$**$$$*$$*$$$*$$*$$$*$$$$$*$$$$$*$$***$$$$$$$$$$*$$*$$*$$******$$$$$$$$*$$$$$$$$$*
$$$*$$$$$*$*$*$*$$$*$*$$$$**$$$$$$$$$$$$$$$*$*$$$$$$***$$$$$*$$$$$$$$$*$$$$$$*$$$***$$***$$$
$$$*$$$*$$$**$$$$$$$*$**$**$$*$$*$**$$$$$*$$$$$$$*****$*$$$*$$$$$$*$*$*$$$$$$$$***$$$*$$*$$$
$$$$$$$*$$**$$$$$$*$$*$$*$$$*$$$***$$$$$$$$**$$$$*$$$$$*$$$$$$*$*$*$***$$$$$*$$*$***$$*$*$$$
$$$$$$$$*$$**$*$**$$$$$$$$$$$*$$$$$$*$$$$$$$$$$*$$$$$$$$$$$$$*$$$$$***$$*****$$$$*$$*$$*$$*$
$$$*$$$$$$*$$*$*$*$$$$$*$$*$$$$$$$$$*$$$$**$$$$$*$$$*$$$$$*$$$$$$$$$*$*$$$$$$$$$*$$$$$**$$$$
**$$$$**$$$$**$*$$$*$$$$$$$$*$*$$***$$**$*$$$*$**$$$$$*$$$$*$$$*$*$*$$$$$*$$$$**$$$$$$$$$*$*
$**$$**$****$$*$$*$$**$$$$*$$$$*$*$$*$$$***$$$$*$$$$$$$$$$$$$$*$$$$$$$$$$$$$*$***$$$$$$$*$$$
$*$*$$$$*$**$$$*$*$$$$$**$*$$*$$*$$*$$$$$$**$$$$**$$$**$$$**$$$**$*$$*$$$$$$$*$$**$*$**$$$$$
$*$*$*$*$$$$**$$$**$$$$$$$**$*$$*$*$$*$*$****$**$*$$$$$$$$$$*$$*$$$$$$$$$$$$$$$$$$$$$$$$$$*$
$$$$$$$$$**$$$$$$$$$$$$$$$*$$*$*$*$*$$$$**$$$***$$$$$$*$$$$$$$$$$$$$$$$*$****$$$$$$**$$$*$*$
$**$$$$$*$$*$$$$$***$$$$$$**$$$$$$$***$*$$$*$$$$****$*$*$$$$$*$***$$*$$$****$$$$*$*$*$$$$&*$
$***$*$$$**$$$$$$$$$*$*$$**$$$$$$$$*$**$$*$*$*$$$$$$$*$$$$$*$$$*$$$$**$**$**$**$$$*$$$$*$$$$
*$$$****$*$$$$*$$*$*$$$***$$$$****$*$*$$$$*$$$*$$*$*$$*$$*$*$*$**$$*$$$$$*$*$$$$$$$**$*$$**$
*$$$*$$*$$$$*$$*$$$$**$$*$$$*$$$*$$*$$$$$*$$*$$**$$$*$*$$*$*$**$*$$$$$$$$*$$$$$$$$$$$*$**$$$
$*$$$$$$$$$*$$$$$$*$$$$$$*$$**$$$$$$$$$*$*$$$***$$$$$$$*$$$$$*$$$$$$$*$$$$$$$$$**$$$$*$$$$$$
**$$*$$$*$$$$$$$**$$$$$$$$$$***$****$*$*$$*$$*$$*$*$$*$$$$$$$*$$$$$*$$$$$$$$$*$$$**$$$$*$$*$
$$$$*$$$$$$*$$$**$$$$$$*$$$$$$**$$$$$$$$$$$$$*$$$$$$$$*$*$$****$*$$$$$*$$$*$*$$*$$$$$$*$$$$$
$*$$***$$$$$**$$$*$$$$*$*$*$$$$*$$$$$$*$$*$$$$$$$*$*$$$$$$$*$$$$$**$$$*$*$$$*$*$*$$$$*$$$$**
$**$$*$$$*$$$*$$$$$$$$*$$$*$$$$$$$$*$$**$*$$$$$$*$*$$$$$$$**$**$$*$$*$*$$$$$$$*$**$$*$*$$$$$
*$*$$$$$*$$$$$$$$$$$$**$*$*$**$$$$$$$**$$$$$$$**$$$$***$*$$$$**$$*$*$$*$$**$$$$*$***$$$**$$$
$***$*$$$*$$$**$*$*$$*$$$*$**$$$*$$$**$$**$**$$$**$$$$$$$*$$$$$*$*$***$$$*$$*$*$$$$**$*$*$$$
*$$$$$$*$$*$$*$**$*$$$$$**$$*$$$$$*$$*$*$$*$$$$$**$*$*$$$$$$$$*$**$*$**$*$$**$*$$***$$$**$*$
$$$$*$$$*$*$*$**$**$$$*$$**$**$*$$*$$$$$**$$$$**$$**$$$$$$*$**$$$$$$$**$$$$$*$*$**$$***$*$$$
$$**$**$***$$$*$**$*$$$$$*$$$*$$$$$*$*$$$$*$*$$$$$$$*$$$$$$*$*$*$*$$$$*$****$$$$$$$$*$$*$$$$
$$*$$$$**$$**$*$**$$$*$$*$$$$$**$*$*$$$$$$$*$$$$$$$$$$**$$$*$$**$$$$$*$$$$$$*$$$$**$$$$$*$$*
$$$$$$$$$*$$$$$$$$$*$$***$$$$*$$*$$$*$$*$$$$$$$$$$$**$$$$$$$$*$*$$*$$$*$$$$$****$*$$$**$$$*$
$$$$*$**$$**$$$**$$*$$$$***$$$*$**$$*$$**$$$$$$$$$$*$$$$$$$*$$$$$$*****$$*$**$$**$$$$**$*$$$
*$$$**$$$$$$$$$$$$$$$$$*$*$$$*$*$$*$$$*$**$$$*$$$*$$$*$$$$$*$**$*$$$**$*$$*$*$*$*$$$$$$$$$$$
$$*$$*$$$$$$$$$$$$$$****$$$$$*$*$$*$$$$$$$$$$*$$*$*$**$$**$*$$$*$*$$$$$$$$$$$$$$*$$*$****$$$
$$*$***$$**$*$$$**$*$$$$$$$$$$***$*$**$$$*$*$$$$$$*$*$$$$$$*$*$$$$$*$$$$$$$$$*$*$*$$$$$$$*$$
$$*$$*$$$$$$**$$$$$*$*$$$**$$$$*$$**$$$*$$$$$*$$**$$*$$****$$**$$*$$$$*$$*$$*$$$*$**$$*$$*$$
***$*$***$$**$$$$$**$$*$*$$*$*$$$$$$$***$*$**$$$*$*$$*$$****$$$$$$*$$$$$$$$$$$$$$$$$$$$$$$$$
*$$$*$$$*$$$$*$$$*$$*$$$*$$$$$$$$$$$$**$*$$$$$*$$*$$$*$$*$$$$$*$*$$*$*$$**$$$*$$$$$$$$*$$*$$
$$$$*$$$$*$$$$$*$$**$*$$*$$*$$*$**$$*$***$$*$$**$$$*$$$**$$$$$$$$*$$$$$$$*$$$$$$$$*$*$$$$$$$
**$$$$$$$$$$*$$$$$$$**$$$*$$$$**$*$$$$*$**$$*$$*$*$$$$*$$**$$$$$$$*$*$**$**$*$$$$*$$$*$$$$$$
$$$$$*$*$*$***$$*$$$$*$*$$$$$*$$*$@$*$$$*$$$$$$$**$**$**$*$*$$$$*$$$*$$$$$*$$$$*$*$**$$$$*$$
$$$$*$$$*$$*$$*$$$**$$*$$**$*$$$****$$$*$**$*$$$$**$$$$$$$$$$$$$$$*$**$$*$$$$$***$$$$$$*$**$
$*$$$$$$$$$$*$$$**$$*$$$$*$*$$$*$*$$$$$$$$$$$*$$*$*$$$$$$$*$*$$$$$$$$$$$$*$$$*$*$****$$$$$$$
*$$$$$$$*$$$$*$$$$*$$$$$$$$$$$*$$*$*$$$$$$$**$$$$$$$*$***$$*$$$**$$$$$**$$$$*$$$***$$*$$$*$$
$$$*$*$$*$$*$$$*$$$**$*$***$*$$$*$$*$*$*$**$$$***$*$*$$$$*$*$$$**$$$**$$$$$$$$$*$$*$$*$$$$$*
$$$$$$$$$$$*$*$$***$$$$$$*$$$$$$$$$$$$$$$$$$*$*$*$$*$$*$*$$$$$$$$$$$******$*$$$$$$*$$$$*$$$$
*$$$*$*$$*$$$$*$$$$$$$$$$*$$$$$$**$$$$$**$$$$$*$$$$$$$*$$*$$$$$*$$$$$*$$$**$**$$$$*$$*$**$**
$$*$$$$$$$$$$$$***$$*$$$$**$*$***$*$$$$**$$*$**$$$*$*$$$*$$$*$*$$*$**$*$$$$*$*$$$$$*$$$*$*$$
$$*$*$$$$$$**$$$*$$$$$*$$$$*$$$$$$*$$*$$*$*$$$$$**$**$$$$$$$*$$**$$$*$$$$$$$$$$$*$$**$$$$$$$
$$$*$$*$$$$*$$$$$$$$*$$$**$$***$*$**$$$*$$$$*$$$*$$*$$$$$$$$$$*$$$$$$$$$$$$$***$$$$$$$$$*$$$
$$*$$$$*$$*$$$*$$$$**$*$*$$$$$*$$****$*$$$*$$$$$*$*$$$$$$*$$$**$$$$$***$*$$$$*$$$$**$$$$*$*$
*$*$$$*$$$$$$*$$***$$$$*$$$$$*$$$$*$*$**$*$$$$*$**$$*$*$*$$$$*$$$$$$*$*$$$$*$*$$*$$*$$$*$$*$
$$$$$$$$*$$*$*$$$$*$*$$****$$$$$$$$$$*$$*$$$*$$$$*$$$$$$$*$$*$**$$$$$$*$$*$*$$$$$**$$*$$*$$$
