**$*$$***$*$*
$$*$*$$$$$*$$
$$$$**$$*$*$$
$$$$$$$$$**$$
$$$$**$$$**$$
*$$$$$$*$*$$*
$$$$$$$$*$$**
$*$**$$$$$*$$
$*$$$*$$$$$*$
*$$$$**$$$$$$
$**$$$*$$$$$*
$***$$**$$$$*
*$$**$$*$*$*$
*$$$$$*$*$*$@
$$$$$*$$$*$*$
$$*$$$*$*$*$$
*$$**$*$$$$*$
$$*$*$**$*$$$
**$$$$*$$***$
***$**$$$*$$*
$$$$$$$$$$**$
$$$$$$$$$$$$$
$**$$$$*$$$*$
$*$$$$*$$*$*$
$$$$*$$$$$$$$
$$$$*$$**$$$*
$$$$*$*$$$$$$
$$$$**$$$$$*$
$$$$*$**$$$$$
$$$*$$$$$$$$$
$*$*$*$$$$*$$
$$*$$$$*$$$**
$$$$*$$$***$$
*$$**$$*$$**$
$$$$$$*$*$***
$$$$$$$$$$$**
$$*$$$$$$$$$$
**$$*$$*$$$*$
***$$$$$$$$$*
*$$$*$**$$$$$
$$*$*$$*$*$$$
