*$$****$$$$$$$*
$&$$$*$$$*$***$
$$$*$$*****$*$$
***$$*$$$*$$*$$
$$$$*$$$*$$$$$$
****$*$*$$$$$$$
*$$*$*$$$$$$$$$
$$$$*$$$*$*$*$*
$$$$$$$$$$*$$*$
$$*$$$$*$$$$$$$
$**$***$$*$$**$
$*$*$$$**$**$*$
*$$$$$*$$$*$$$$
*$$$**$$$$$*$$*
$$$$$*$*$*$$$$$
*$$$*$*$*$$$**$
$*$$$$*$$*$*$$$
$$$*$$*$$$$$$$$
*$$**$$$$$*$$*$
$$$$*$$**$*$$*$
$$$**$$$$$$$$$$
$$$$*$$*$$$*$**
*$*$$*$$$$$****
$$*$*$$$$$**$$*
$**$$$$$*$$*$$$
*$**$$$*$$$$$*$
$$$$@$$$$*$$**$
