*$$*$$$$$$*$$$$*$*$*$$$$$$$$$$$$$$$$$*$*$$$$***$$*$$$$$**$$*$*$*$$*
$$***$****$$$$*$$*$*$*$$$$$$$**$$$*$$$$*$$$$$**$$*$**$$$*$$$$*$$*$*
$$$$$$*$$*$$$$$$*$$**$*$$$$$$$$$*$*$$$$$$*$**$$$$$$$*$*$$$$$$$$***$
$$$***$$$$**$$$$**$$$$$$$$$$$$*$$$**$**$***$$$*$*$*$*$$$$$$$*$$*$$$
$$**$$$$$$*$$$*$$$****$$$$$*$$$$$*$$*$$*$$*$$$*$**$$**$$$$$$$*$$$$$
$$*$***$$*$**$$$*$$**$$$$$$$$$$*$$$$$$$$**$$$$*$$$$$**$$$$$$$$$$$$*
*$$$$*$$$$$$$$$*$$$$**$$$$$*$*$$$***$***$*$$*$*$*$$$$*$****$$$$$$$$
*$*$$*$$**$$$*$$$$$$$$$$***$$$$*$$$$*$*$$$$$**$$$$$$$$$$*$$$$*$$$$$
$$*$$$$$$***$$*$$*$$*$*$$**$$$$*$$$$$$**$*$**$$$$$$$$$*$$$$*$$$$**$
$*$$$****$$***$$$$$$*$$$$$$$*$*$$$$$$$***$$$$*$$$*$$$*$$**$$$$*$***
**$$$$$*$$$*$*$$$$$**$$$$$$$$****$$$$$$$$*$$$$$$*$$$$$$**$*$$$*$$*$
$$*$$*$$$$*$$$*$$*$$*$$$$$$*$***$$$$**$$$$*$$$$**$$$$$*$$$$$$$$$$$$
*$$*$$$$$$$$$$$$$*$*$**$$$*$$$*$$$*$$$$$$*$***$$$$*$$*$$$$$*$$$$$*$
$*$**$$$$$$$$$$$$$$*$$$*$$$$*$$*$$$$$$$$$$*$$*$$$$$$$$$$$$$$$$*$$$$
$$$$**$$$*$$$$$$$*$$$*$**$$$$**$$***$$$$**$$*$$*$$$$$$$$$$*$$$$****
$$$$$$**$$*$**$$*$$$$*$$$**$$$$**$**$$*$$*$$$$$$*$$$$$*$$$*$$$***$*
*$*$**$$**$$$$*$$$$$*$$$$$$$*$$$*$*$*$$$*$$$$**$*$$***$*$****$*$***
$$$$$**$$****$$$$$$$$$$$*$$*$$$$$$$$$$$$$$$$$$$$$$$$$$*$*$$$$$$$*$$
$*$$*$$$$$$$$$$$$*$*$$$$$**$$*$$$$*$$$*$$$$$$*$$$*$$$$$$$$$$$$$$*$$
*$$$$**$$$$$$$$**$$$$*$***$$$$$$***$**$$$$$$$$$***$$$$$*$$$$*$*$$$$
*$$*$$**$*$$$$*$*$$$$*$$*$*$$$*$$**$$**$$$$$$*$$$$*$$$$$$$$$$$$$$*$
*$$$*$**$$$$**$$$$$$$*$$$$*$$$$*$$$*$$**$*$$$$$$$$$**$*$$$$$*$$*$$*
$*$$*$$$**$$*$$$**$$$$**$$$$$$*$$$*$$$$$$$$*$$$$$$$**$$*$$$$$*$$$**
$$$***$$*$*$$$$*$$$*$*$$$$$$*$$*$*$$$*$*$$$$*$$$$$$*$*$$$$$$*$$$$$$
$$$$*$$$**$$$$$$*$$$*$$$$$**$$$$***$$$**$$$$*$*$$*$$$$$$$$$$*$$$$**
$$$$$$$*$$$$$*$$$$$$$$*$**$*$$$**$$*$*$$*$$$$$$$$$$$$$*$$*$$$$$$$**
$$$$$$$**$**$$$*$$$$$$$*$*$$*$$$*$$$*$$$$$$$$$*$$$$**$$$$$$$$$$$$$$
$$$$*$$$**$$$$$$$*$$$$*$$$$****$$$**$$$$*$$$$$**$$$*$$*$*$$$$$$*$$$
$***$$$$$$$$$**$$$$*$$*$$**$$$$*$***$$$$$*$$$$$$$$$$$$*$$$$$$$$$$$*
$*$$$$***$***$$$$*$*$$$$$*$***$$$$*$*$$$$*$$$*$**$**$**$$$*$$*$$*$$
$$$*$$$$$$$$*$*$*$**$*$$$$***$$$*$$$$$$$$$*$$$*$*$$$$$$$$$***$$$*$$
**$$$**$$$$$$*$$$**$$$$$$$$$*$$$$$*$$$**$$*$$$$$*$***$***$$$$$$$$$$
$$$$$$$**$$$$$***$*$*$$*$$$$*$$$*$$*$$$$$$*$$$*$*$$$$$$$$$*$**$$$$$
$$$$*$$***$$$***$$$$*$$*$*$**$*$$$$*$*$$**$*$$$$**$$*$$$$$$$*$$*$$$
***$$$***$$$$$***$***$$$$$$$*$$*$$$$*$$$$$$$*$$*$*$$*$$*$$*$$*$$$$$
$$$$*$*$$$$$$$$**$$*$$*$$$$$$$$$**$$*$$$$$$$**$*$$*$$$$$**$$$$$*$*$
$$$$*$$$$*$$*$$$*$$$$$$$*$$$$$$$$$$$$*$$$$*$$$$$$$*$*$**$$$*$$*$*$$
$$**$$$$$$*$$$*$$*$$*$$$$$$$$$$$$$*$$$**$$$$$***$$$$$$*$$$$**$$$*$$
$$$$$*$$$*$$**$$$*$$$$$$$$$$****$$$**$$*$$$*$$*$$*$*$$*$*$*$$*$*$$$
$*$$$*$$$$$*$*$$$$$*$****$$*$$$$$*$$$$$$$$$$$$*$$$***$$$$***$*$****
$$$*$$*$$$$*$$$*$$$*$$*$$$$$$*********$*$$$*$$$*$*$*$$$$$$$*@$$**$*
$*$$$$$$$$$$*$$$*$$**$$$$$$$$$$$$$$**$*$*$*$$**$$**$$*$*$$$$$$$$$$$
$$$$*$$$**$$$$$*$*$$$$***$*$*$$$$$$$$$$$$$$$*$$$$*$$$$$$$$$*$$$***$
$*$$$$$$$$**$*$*$$*$*$$*$*$*$$$**$$$**$$$$$**$$$$**$$$$$*$$$$*$***$
$$$$$$$$$*$$$$$$$$$$$$$$$$$$*$$$$$$*$$$$$*$$$$$****$$***$$$*$*$$$**
$***$*$$$$*$$*$*$$**$$$$$$$$$$***$$*$$$$$$$$$*$*$$*$$$$*$$*$***$$$*
$**$$$$$$$$$$$$$*$$$$$$*$$$$$$*$$$**$$$$$*$$$**$*$**$*$**$$$*$$*$$$
$$$*$$*$$$$*$$$*$**$$$$$$$$$$*$*$$$$$*$**$$*$$$$$$$*$*$$$$$***$*$*$
$*$*$$$$**$$$$**$$*$$$**$$*$*$$$*$$$$$*$$$$$$$$$$$$$$*$$$*$*$$$*$*$
$*$$$**$$$***$*$$$*$*$$$**$$*$$$*$**$$$$$***$$$*$$*****$$**$*$$$$$$
$$$*$$$*$$*$$$$$*$*$$$$$**$$$*$$$$$*$$$*$*$$*$*$*$**$$*$$$$*$$**$*$
$$$***$$$$$$*$$$$$*$$$$**$*$$$***$$$$*$$$$$$*$*$**$$$$*$**$*$$$$$$$
*$$**$$$$$*$$*$$$$$$$$$$**$$$$$$$$$$$**$**$$$*$$$$$$$$$$$$$$$$**$$$
*$$*$$$$$*$$*$$*$*$$*$$$*$**$$*$$*$$$$*$$$$$**$$$$$*$*$$*$*$$$*$***
*$$$$$$*$**$$$$**$$$*$$$$$$$$$$$$$$$$$**$$$$$*$$$$*$$*$$*$*$**$$$$*
*$*$$$*$$$$*$$$$$$$$**$*$$**$*$$$*$$$$$$$$$$*$$$$$$$*$$$**$$**$$$$*
$**$$$$$$$$$$$$$*$*$*$*$*$$*$$$$$$*$$*$$$$**$**$$*$$$$*$$$$$$$$$$$$
*$$$**$$$$$*$*$*$*$$$$*$$$*$$$$$$$***$$$***$$$$***$$$$$$$$$$$$$$$$$
$$*$$*$$$$*$$$$$$$$$**$$$**$$$$$$$$$$*$$$*$$$$$***$$*$$$$*$$**$$$$$
$*$*$$*$$$*$$$$***$*$$**$$*$$$*$$$$$*$$$*$$$$$$$*$$*$$$***$$*$$$$$$
$$***$$$*$$$$$*$$$$$*$$$$$$$*$*$$$$*$$*$$**$*$$$$$$$*$$*$$$$$$$$$$*
$$$*$*$*$$$$$$*$$*$$*$$$$*$*$$*$*$$$$$$***$*$$$*$$$**$*$*$$$$$$$$$$
*$$$*$$$$$$*$$$$$$$$$$$$$$*$*$$*$$$*$$$$$$$**$$$$*$****$$$**$*$**$*
$$$$$*$$$$$$*$*$$$$$*$*$**$**$**$$$$$*$$$$$$*$$$$*$$$$$*$$$$$$$*$**
$$**$$*$$*$$*$$$$$$$$$$$*$*$*$$$*$$$$*$**$$*$$$$*$$*$$$*$$$$$*$*$$*
$$$$$$*$$$**$*$$$$$$***$$$$$$$$$$$$*$$*$$$*$*$$*$$$$$$$*$*$$$$$*$$$
$$$$*$$**$$$$**$$$*$$$$*$*****$$$*$$$$*$$$**$**$$$$$$**$$$*$*$*$$*$
**$**$$$*$$$$$$$*$$$*$*$$$$$$$$$*$$$$*$*$*$$$$$$$$$*$$$$$$*$$$$*$**
$$**$*$**$*$$$$$*$$$$$*$$$$$$$$****$*$$$$$$$$*$$$*$*$$*$$*$*$$$*$*$
$*$**$*$$$$$$$$$*$$$*$*$$$**$$*$$$$*$$**$*$$*$$$$$$$*$$$$$$*$$*$**$
*$$$*$*$$$$$$$$$*$**$*$$**$$$$$*$$$$*$*$**$*$$$$$$$**$*$*$$$$$$$*$$
$$$$$$*$$$$$$$$$*$*$$$*$$$$$$$$$$***$$*$*$*$**$$$*$*$$$$$$*$$$$$$$*
*$*$$$**$$*$$$$$$$$$$*$*$$$$$$$$$$$$$*$$$$$$$$$$$**$$*$$$$$$$**$$$$
$$$*$$*$$*$$$*$$$*$*$$$***$$$$*$$*$**$$$$$$**$$$$*$*$*$$$$$$$*$$$*$
$$$*$$$$$$*$*$**$$**$*$*$*$*$$$*$*$*$*$$$$$$*$$*$$$$$$*$*$$$****$$$
$*$$$$***$$*$$$$$$$**$$$$*$$$$$$$$$$$*$$$$$**$***$*$*$*$$$$$**$$**$
$$$$*$$*$*$$**$$*$$$$*$$$$$$$$$$$*$$$$$$$$*$$$$$$$$$$$$$$***$*$$$$$
$*$*$$$**$$$$$*$$*$$$$$$$$*$*$$$$$$*$$***$$*$$$$$*$$*$$$*$*$$$*$$$$
$$*$$$$**$*$$$$$$$$$*$$*$$$$$$***$$****$$*$***$$$$$$$$$$$*$$$$**$$$
$$$$$$$$$*$*$$*$*$$$$$$$$$$$$$$**$$$**$*$***$$$*$$$$$$$$$$$$***$$$$
*$$$$$$$$$$$$$$*$***$$$*$$$$*$$$*$$$$$$$$*$$*$$$$$$$$$$$*$$$*$$$**$
$$$*$$$$*$$$$$**$*$$$$$$$$$$$$$$$$$$$$$$*$*$$**$$*$$$$$$$*$$$$$*$*$
$$$$$$$*$**$$*$*$*$$$$$***$$$$*$$*$$**$*$$*$$$**$$*$$*$$$$$$$$**$$$
*$$$*$$$$$**$$**$***$$$*$$$$*$$$$$$***$$*$$$$$$$*$$$*$*$*$**$*$$$$*
**$$$$$$*$**$$$*$**$$$$$$$$$$$$*$**$*$$$$**$*$**$$$$$*$$*$*$*$$$$$$
$*$$*$$**$*$**$$$$$$$$$$$$$**$$$$$$**$$$$$$$$*$*$*$$$*$$$$$$$*$$$$$
$$$$$$$$*$*$$*$**$*$$$$$$$$$$*$$$$$$$$*$$$*$*$***$$$*$$$$$$$$$$$***
$*$$$*$$*$****$$**$*$$$$*$$$*$$$$$$*$*$$$$$*$*$*$$$$*$$$$$$*$$$*$*$
$*$$$$$******$$*$$$***$$*$$$$$$$$$*$*$$$$$$*$*$$$$$*$$$*$$$$$$$**$*
$*$$$$$$$$$*$****$$$$$*$$$$$*$$*$$$*$*$$$$$$*$$*$$$$$$$$$*$$$*$*$*$
$$$$$$$***$*$$*$$*$$$$$$$$*$**$$$$$$**$$$$*$$$*$$$*$$**$$$$$$*$****
**$$*$**$*$$$$$$**$**$*$**$*$$*$$$$$$$$$*$$$$*$$**$$$$$$$$$$***$$$$
$$*$$$$**$$**$$$$$$***$$*$$$$*$$$*$$$$$*$$$**$$$*$$$*$$$$$$*$*$$$*$
$*$$$$$$$*$$$$$$*$**$$$$$$$$**$*$$$*$$$*$$*$$**$***$$$$*$$$*$$$*$*$
$$$*$$**$*$$*$$*$$$$$$$*$$*$$$$$$$$$$$$$*$$$$$$*$*$$$$$**$$**$$$$$$
$*$$$$$$$***$$***$*$*$$$$*$$$$$$$$*$$$$$$$$$$*$$$$$$$$$*$$*$$**$$**
$$**$*$*$$*$$***$**$$$$*$*$$$$$*$$$$$*$$$$$$$$$$*$*$$$*$$$$$$$*$$$$
*$$$$*$$*$$$*$$$*$$$$$$$$$$$*$*$$**$$*$**$$*$$$$$$$$$$$*$$$$$$$$$$$
